R 1350 900

NO	./imgs/sand.xpm
EA 	./imgs/sand_2.xpm
SO	./imgs/snad.xpm
S	./imgs/boss.xpm
WE 	./imgs/wood.xpm

F    30,150,30
C    30,30,170

   11111111111111
   10010000000001
   10010000000001
1111000001000111111111111111
1000000000000100000000010001
100000000100000100010100011
100000000000011111111111111
11111100000S011
11110000010000011
100000000000011111111
10200000102011
10000200000001
1111111111111
