R 1350 900

NO	./imgs/sand.xpm
EA 	./imgs/sand_2.xpm
SO	./imgs/snad.xpm
S	./imgs/boss.xpm
WE 	./imgs/wood.xpm

F    30,150,255
C    30,30,170

   11111111111111
   10112101210101
   10110101010101
  110010002002001
  110010020200001
  110010000000001
  110010000000021
1101000001000111111111111111
1000002000000112121212121211
1000002000000100000000010001
100E00000100000100010100011
100000000000011111111111111
111111000000011
11010000010000011
102220000000011111111
10222000100011
10222000100011
10000000000001
1111111111111
